wMwwwwwwwwwwwww
wOOOOOOOOOOOOOw
wOwwwwwOwwwOwOw
wOwOOwOOOOOOwOw
wOOOwwwwOwwwwOw
wwwOwOOOOOOOwww
wOwOOOwwwOwOOOw
wOwOwOwOOOOwwOw
wOwOwOwwwwOwwOw
wOOOwOOOOwOOOOw
wwwwwwwOwwwwwww
wOwOOOOOOOwOOOw
wOwOwwwOwwwOwOw
wOOOwOOOOOOOwOw
wwwwwwwwwwwwwGw